R 1920 1080
NO ./textures/wolf/redbrick.xpm
SO ./path_to_the_south_texture
WE ./path_to_the_west_texture
EA ./path_to_the_east_texture
S ./path_to_the_sprite_texture
F 224,205,169
C 191,226,243

1111111111111111111111
1000000000000000000001
1000000001110000000001
1000000000N00000000001
1000000001110000000001
1000000000000000000001
1111111111111111111111
