1111111111111111111111
100000000000000000000111111
111111100000000000000000001
100000000000000000000111111
1000000000000000000001
1111111111000000000001111111111
		 1000000000000000000001
		 1000000000000000000001
		 1000000000000000000001
1111111111000000000001111111111
100000000000000000000111111111111111111111
100000000000000000000000000000000000000001
100000000000000000000000000000000000000001
111111111111111111111111111111111111111111
