R 640 480
NO ./textures/mur1.xpm
SO ./textures/mur2.xpm
WE ./textures/sol.xpm
EA ./textures/wolf/redbrick.xpm
S ./path_to_the_sprite_texture

F 224,205,169
C 191,226,243

11111111
10000001
100N0001
10000001
111011111111111111
111000000000000001
111000000000011111
100000000011110001
111110000010010001
100000000011110001111111
100000000000000000000001
111111111111111111111101
                     1011111
                     1000001
                     1111111
