R 384 216

NO ./textures/mur1.xpm
SO ./textures/mur2.xpm
WE ./textures/sol.xpm
EA ./textures/wolf/redbrick.xpm
S ./path_to_the_sprite_texture

F 224,205,169
C 191,226,243

11111111
10000001
10000001
10000001
100N0001
10000001
10000001
10020001
10020001
10000001
11111111
