R 640 480
NO ./textures/mur1.xpm
SO ./textures/mur2.xpm
WE ./textures/mur3.xpm
EA ./textures/wolf/redbrick.xpm
S ./path_to_the_sprite_texture

F 224,205,169
C 191,226,243

1111111111111111111111
1000000000000000000001
10000000011100000000011111111111
10000000000000000000000000000001
10000000011100000000010000000001
10000000000000000000010000000001
11111111111111000111110000000001
10000000000000000000011100000001
10000000000000000000000000000001
11111111111011111111111111111001
          101               1011
          101               101           111
11111111111011111111111111111011111111111110111
1000000000000000000000000000000000000000000W001
11111111111111111111111111111011111111111111111
                            111
