R 500 350

NO ./textures/mur1.xpm
SO ./textures/mur2.xpm
WE ./textures/sol.xpm
EA ./textures/wolf/redbrick.xpm

S ./textures/wolf/barrel.xpm
F 224,205,169
C 191,226,243

1111111111111111111111111
1000000000110000000000001
1011000001110000002000001
1001000000000000000000001
1111111110110000011100001
1000000000110000011101111
1111011111111101110000001
1111011111111101110101001
1100000011012101110000001
1002200000000002110000001
1002200000N00002110101001
1100000111010101111101101
1111011111110101110111101
1111111111111111111111111
