R 640 480
NO ./textures/mur1.xpm
SO ./textures/mur2.xpm
WE ./textures/sol.xpm
EA ./textures/wolf/redbrick.xpm
S ./path_to_the_sprite_texture

F 224,205,169
C 191,226,243

1111111111111111111111
1000000000000000000001
100000000000111100000111111111111111111
100000000N001  100000000000000000000001
100000000000111100000111111111111111111
1111111111111111111111
