R 1920 1080

NO ./textures/mur1.xpm
SO ./textures/mur2.xpm
WE ./textures/sol.xpm
EA ./textures/wolf/redbrick.xpm
S ./path_to_the_sprite_texture

F 224,205,169
C 191,226,243

11111111
10000001
10000001
10000001                                                  111111
1110111111111111111111111111111111111111111111111111111111100001
1110000000000000000000000000000000000000000000000000000000000001
1110000000000111111111111001111111111111111111111111111111100001
100000000011110001      1001                              111111
111110S00000100001      1001
1000000000111100011111111001
1000000000000000000000011001
1111111111111111111111011001
                     1011001
                     1000001
                     1111111
