R 640 480
NO ./textures/mur1.xpm
SO ./textures/mur2.xpm
WE ./textures/mur3.xpm
EA ./textures/mur4.xpm
S ./path_to_the_sprite_texture
F 224,205,169
C 191,226,243

1111111111111111111111
1000000000000000000001
10000000011100000000011111111111
10000000000000000000000000000001
10000000011100000000010000000001
10000000000000000000010000S00001
11111111111111000111110000000001
10000000000000000000011100000001
10000000000000000000000000000001
11111111111011111111111111111001
          101               1011
          101               101
1111111111101111111111111111101
1000000000000000000000000000001
1111111111111111111111111111101
                            111
