R 1200 600

NO ./textures/mur1.xpm
SO ./textures/mur2.xpm
WE ./textures/sol.xpm
EA ./textures/wolf/redbrick.xpm

S ./textures/wolf/barrel.xpm
F 224,205,169
C 191,225,243

111111111111111111111111111111111111
100000000011000000000000000000000001
101100000111000000200000111111010001
1001000000000000000000001    1010011
1111111110110000011100001    101001
10000000001100000111011111111101001
11110111111111011100000000000000011
1111011111111101110101001111111111
1100000011212121110000001
1002200000000002110000001
100220000N000002110101001
1111111111010101111101101
       111110101110111101
       111111111111111111
