R 720 480

NO ./textures/mur1.xpm
SO ./textures/mur2.xpm
WE ./textures/sol.xpm
EA ./textures/wolf/redbrick.xpm

S ./textures/wolf/barrel.xpm
C 0,225,243
F 224,205,169

1111111111111111111111111
1000000000000000000000001
100000000000S000000000001
1000000000000000000000001
1111111111111111111111111
